티커,종목명,시가,종가,변동폭,등락률,거래량,거래대금
095570,AJ네트웍스,6110,5720,-390,-6.38,2947645,17162545200
006840,AK홀딩스,15150,17200,2050,13.53,455492,7706148650
027410,BGF,4365,4305,-60,-1.37,14388855,62685829240
282330,BGF리테일,205500,210500,5000,2.43,712994,146603104000
138930,BNK금융지주,7390,6500,-890,-12.04,37130723,264104001940
001460,BYC,372000,366000,-6000,-1.61,8796,3220110500
001465,BYC우,140000,142500,2500,1.79,1545,218162000
001040,CJ,76700,84100,7400,9.65,1066219,86457562004
079160,CJCGV,17550,16950,-600,-3.42,8422062,160268026800
00104K,CJ4우전환,70100,72900,2800,3.99,84718,6051684700
000120,CJ대한통운,88400,93700,5300,6.0,1512762,136894091300
011150,CJ씨푸드,2755,2875,120,4.36,15038899,47763850690
011155,CJ씨푸드1우,25000,25850,850,3.4,25577,724526800
001045,CJ우,49600,49200,-400,-0.81,51907,2602142350
097950,CJ제일제당,395000,380500,-14500,-3.67,706709,269158868000
097955,CJ제일제당우,171000,168500,-2500,-1.46,42839,7276678000
000590,CS홀딩스,62800,57600,-5200,-8.28,30197,1826604700
012030,DB,834,803,-31,-3.72,12946841,12423761635
016610,DB금융투자,4565,4100,-465,-10.19,2184105,9944895615
005830,DB손해보험,62100,65300,3200,5.15,2547552,164139882288
000990,DB하이텍,44600,37150,-7450,-16.7,6486630,270214162050
000995,DB하이텍1우,92400,68900,-23500,-25.43,11662,945317300
139130,DGB금융지주,7920,6990,-930,-11.74,18078170,139728471790
001530,DI동일,15802,15050,-752,-4.76,1795164,30047623750
000210,DL,68800,59200,-9600,-13.95,1235803,78130635600
001880,DL건설,15750,14850,-900,-5.71,801995,13236875500
000215,DL우,37550,33900,-3650,-9.72,32106,1155846300
375500,DL이앤씨,41850,33750,-8100,-19.35,3228619,120943158700
37550L,DL이앤씨2우전환,29450,25700,-3750,-12.73,36442,1014583650
37550K,DL이앤씨우,26250,23300,-2950,-11.24,46554,1179443150
007340,DN오토모티브,76200,64100,-12100,-15.88,666945,46124152100
004840,DRB동일,4385,4080,-305,-6.96,214227,924540695
155660,DSR,6370,5530,-840,-13.19,661157,3987517670
069730,DSR제강,5770,4775,-995,-17.24,1418196,7602793205
017940,E1,49350,45450,-3900,-7.9,248362,11883309350
365550,ESR켄달스퀘어리츠,4025,3990,-35,-0.87,5369095,21146172469
383220,FF,151500,144500,-7000,-4.62,4181750,613384198500
007700,FF홀딩스,28550,30450,1900,6.65,25128861,768791922800
114090,GKL,16900,18900,2000,11.83,9218061,166763481700
078930,GS,48600,43800,-4800,-9.88,2739672,125956450150
006360,GS건설,23400,21150,-2250,-9.62,22787652,527856708950
001250,GS글로벌,2710,2250,-460,-16.97,8442198,20896600030
007070,GS리테일,29800,28150,-1650,-5.54,3087384,90304640250
078935,GS우,36050,34100,-1950,-5.41,104865,3751423300
012630,HDC,5740,5490,-250,-4.36,1234515,7087570290
039570,HDC랩스,7830,7600,-230,-2.94,610748,5059920490
089470,HDC현대EP,4175,3955,-220,-5.27,1785911,7613561810
294870,HDC현대산업개발,11050,10000,-1050,-9.5,4620931,49034570570
267250,HD현대,64500,57100,-7400,-11.47,3317919,210970156800
097230,HJ중공업,4430,3915,-515,-11.63,1005809,4172218160
014790,HLDI,3005,2680,-325,-10.82,1559059,4751148285
003580,HLB글로벌,6630,5470,-1160,-17.5,4763569,29488686380
204320,HL만도,48000,40300,-7700,-16.04,4447304,198728332125
060980,HL홀딩스,33350,30750,-2600,-7.8,541435,17432997800
011200,HMM,22300,19550,-2750,-12.33,37585234,810592737100
082740,HSD엔진,7510,7420,-90,-1.2,8757630,65003428680
003560,IHQ,714,423,-291,-40.76,118882427,63610310979
175330,JB금융지주,8420,7890,-530,-6.29,15774714,130886047556
234080,JW생명과학,12350,12150,-200,-1.62,420250,5198450650
001060,JW중외제약,19650,18900,-750,-3.82,1930748,38260720150
001067,JW중외제약2우B,63100,65100,2000,3.17,822,53559300
001065,JW중외제약우,34800,32350,-2450,-7.04,10131,342372400
096760,JW홀딩스,3060,2980,-80,-2.61,858396,2641374355
105560,KB금융,52500,48500,-4000,-7.62,24268298,1259911009773
432320,KB스타리츠,4480,4425,-55,-1.23,1255123,5633778630
002380,KCC,238500,204500,-34000,-14.26,562932,128346167500
344820,KCC글라스,41000,36950,-4050,-9.88,453280,17480606450
009070,KCTC,5050,4550,-500,-9.9,3267451,15840773250
009440,KC그린홀딩스,3235,2820,-415,-12.83,1949951,6105186835
119650,KC코트렐,2550,1820,-730,-28.63,4157557,9147978565
092220,KEC,2420,1955,-465,-19.21,19583258,43555076275
016380,KG스틸,9070,7390,-1680,-18.52,7441862,61337344570
001390,KG케미칼,24150,20550,-3600,-14.91,1077413,24493067900
033180,KH필룩스,960,663,-297,-30.94,75542062,78871481014
001940,KISCO홀딩스,17350,15650,-1700,-9.8,485334,7794927700
025000,KPX케미칼,50700,51000,300,0.59,69728,3550894550
092230,KPX홀딩스,55100,54000,-1100,-2.0,83476,4915162600
000040,KR모터스,592,560,-32,-5.41,3826959,2164728630
044450,KSS해운,9590,9250,-340,-3.55,558675,5310853500
030200,KT,37400,33800,-3600,-9.63,17304497,630509732292
033780,KTG,99900,91500,-8400,-8.41,8030294,775975626588
058850,KTcs,2320,2185,-135,-5.82,1357258,3125745235
058860,KTis,2620,2415,-205,-7.82,1193995,2990442180
093050,LF,16050,15900,-150,-0.93,906620,14757269350
003550,LG,84100,78100,-6000,-7.13,3311035,266389315349
034220,LG디스플레이,14450,12450,-2000,-13.84,23366339,316906689500
051900,LG생활건강,656000,722000,66000,10.06,1433149,1002451026668
051905,LG생활건강우,279500,315500,36000,12.88,386302,116423824250
373220,LG에너지솔루션,587000,435500,-151500,-25.81,7382847,3729892829031
003555,LG우,62500,59700,-2800,-4.48,66054,4104982700
032640,LG유플러스,12100,11050,-1050,-8.68,12762321,150200112700
011070,LG이노텍,310500,252500,-58000,-18.68,4514804,1278893457825
066570,LG전자,97600,86500,-11100,-11.37,14310222,1306132077100
066575,LG전자우,45850,42050,-3800,-8.29,627444,27204587550
037560,LG헬로비전,5110,4400,-710,-13.89,10013249,51726291290
051910,LG화학,740000,600000,-140000,-18.92,3713236,2417218671759
051915,LG화학우,335000,277500,-57500,-17.16,286480,86149086516
079550,LIG넥스원,92500,92200,-300,-0.32,3803813,340660561900
006260,LS,75200,69700,-5500,-7.31,2471736,175538536800
010120,LSELECTRIC,57700,56400,-1300,-2.25,2229696,126008882400
000680,LS네트웍스,2575,2400,-175,-6.8,520231,1276212870
229640,LS전선아시아,8140,7290,-850,-10.44,3547764,28126469560
108320,LX세미콘,87700,71700,-16000,-18.24,2132495,172843292100
001120,LX인터내셔널,41200,33950,-7250,-17.6,6538633,255844237720
108670,LX하우시스,35650,31250,-4400,-12.34,434720,14924923150
108675,LX하우시스우,17350,15900,-1450,-8.36,46204,794346050
383800,LX홀딩스,9430,8460,-970,-10.29,2502845,22626891720
38380K,LX홀딩스1우,11950,11050,-900,-7.53,28157,327306400
023150,MH에탄올,8100,7610,-490,-6.05,602465,4939569810
035420,NAVER,187000,177500,-9500,-5.08,15456239,2881925695860
181710,NHN,24700,24900,200,0.81,971203,23854114450
400760,NH올원리츠,3145,3400,255,8.11,3296673,10873416985
005940,NH투자증권,9630,8770,-860,-8.93,10361203,98240952020
005945,NH투자증권우,9470,8740,-730,-7.71,1233264,11534367070
338100,NH프라임리츠,4015,4040,25,0.62,275564,1111143315
034310,NICE,12550,12900,350,2.79,1161372,15267218400
008260,NI스틸,4920,4475,-445,-9.04,2396617,10802386060
004250,NPC,7090,5820,-1270,-17.91,2891545,18896635380
004255,NPC우,3655,3010,-645,-17.65,278511,950000960
010060,OCI,95100,80800,-14300,-15.04,4998649,451923425600
178920,PI첨단소재,32100,28900,-3200,-9.97,2297283,70568611250
005490,POSCO홀딩스,299500,276500,-23000,-7.68,8156754,2348366041745
010950,S-Oil,87200,83400,-3800,-4.36,6181593,534032456368
010955,S-Oil우,58500,53900,-4600,-7.86,352331,20537490300
034120,SBS,34100,34550,450,1.32,746347,26270844800
005090,SGC에너지,35000,30950,-4050,-11.57,999399,33284439400
001380,SG글로벌,1720,1705,-15,-0.87,20349557,36631518140
004060,SG세계물산,550,534,-16,-2.91,12797807,6945711862
001770,SHD,39300,31900,-7400,-18.83,206856,7525869200
002360,SH에너지화학,953,821,-132,-13.85,17153960,15635658327
009160,SIMPAC,5830,4685,-1145,-19.64,2097970,11508069155
123700,SJM,4550,4200,-350,-7.69,2055317,9702388075
025530,SJM홀딩스,4265,3425,-840,-19.7,1835937,7435656535
034730,SK,219000,189000,-30000,-13.7,2400368,487921917500
011790,SKC,112000,88500,-23500,-20.98,3696040,371067531400
018670,SK가스,128000,115500,-12500,-9.77,180833,21999188500
001740,SK네트웍스,4220,3870,-350,-8.29,6000128,24365158635
001745,SK네트웍스우,48100,37500,-10600,-22.04,39352,1921004200
006120,SK디스커버리,32200,30250,-1950,-6.06,596564,18991863150
006125,SK디스커버리우,29300,28000,-1300,-4.44,31209,909185550
210980,SK디앤디,22950,20050,-2900,-12.64,521975,11204187700
068400,SK렌터카,7040,6660,-380,-5.4,492781,3451685710
395400,SK리츠,4690,5510,820,17.48,12429921,65500681530
302440,SK바이오사이언스,82800,73500,-9300,-11.23,4823048,401936059700
326030,SK바이오팜,73600,72100,-1500,-2.04,1697427,123825912800
402340,SK스퀘어,37450,33550,-3900,-10.41,6039341,214677571446
361610,SK아이이테크놀로지,65900,53000,-12900,-19.58,6256194,383062150700
03473K,SK우,182500,168000,-14500,-7.95,19772,3463466500
096770,SK이노베이션,179000,154000,-25000,-13.97,5174674,864036101500
096775,SK이노베이션우,108000,93900,-14100,-13.06,41011,4093329100
001510,SK증권,691,618,-73,-10.56,13489553,8961555155
001515,SK증권우,2755,2570,-185,-6.72,94024,254605970
285130,SK케미칼,88800,73200,-15600,-17.57,1893431,157364738600
28513K,SK케미칼우,40650,37700,-2950,-7.26,105121,4253145950
017670,SK텔레콤,50000,47400,-2600,-5.2,10436138,516585280192
000660,SK하이닉스,85000,75000,-10000,-11.76,51099671,4084945482189
064960,SNT모티브,44750,42000,-2750,-6.15,497521,22222518150
100840,SNT에너지,22100,18650,-3450,-15.61,2034864,43976363500
003570,SNT중공업,10400,9340,-1060,-10.19,3145086,30273350900
036530,SNT홀딩스,15850,15700,-150,-0.95,317372,5176746950
005610,SPC삼립,69800,71300,1500,2.15,324720,23137982500
011810,STX,7700,5500,-2200,-28.57,59356973,368606491840
077970,STX엔진,13750,13450,-300,-2.18,5639589,80473120950
071970,STX중공업,4805,7080,2275,47.35,49403906,349028603060
002820,SUNL,3440,3100,-340,-9.88,337772,1137440065
084870,TBH글로벌,1955,1640,-315,-16.11,1119206,2044799950
002710,TCC스틸,10650,9350,-1300,-12.21,4660022,45756094830
069260,TKG휴켐스,21500,20000,-1500,-6.98,2669566,57138155700
002900,TYM,2590,2880,290,11.2,141385018,390199774135
024070,WISCOM,2710,2695,-15,-0.55,1904377,5672439215
037270,YGPLUS,4250,4410,160,3.76,14667504,66665617640
000500,가온전선,18300,19500,1200,6.56,1562084,30260829650
000860,강남제비스코,21400,20750,-650,-3.04,75378,1592304900
035250,강원랜드,25050,23200,-1850,-7.39,6833268,165522758750
011420,갤럭시아에스엠,1975,1700,-275,-13.92,1591413,3014283420
002100,경농,10150,10100,-50,-0.49,453775,4683212950
009450,경동나비엔,36600,33800,-2800,-7.65,801870,28411521750
267290,경동도시가스,28050,25300,-2750,-9.8,7313451,213728630500
012320,경동인베스트,125000,98500,-26500,-21.2,2396747,277100989100
000050,경방,11050,10800,-250,-2.26,98080,1088797300
214390,경보제약,6290,10000,3710,58.98,42301803,389271792380
012610,경인양행,4870,4090,-780,-16.02,1249775,5669293230
009140,경인전자,25900,24200,-1700,-6.56,54290,1338552050
013580,계룡건설,19600,18200,-1400,-7.14,1054416,21196216800
012200,계양전기,2900,3170,270,9.31,1861791,5603934650
012205,계양전기우,4975,5200,225,4.52,84534,429734225
002140,고려산업,4230,3470,-760,-17.97,19642243,83574601710
010130,고려아연,630000,564000,-66000,-10.48,1207955,712226365000
002240,고려제강,21942,19500,-2442,-11.13,1699381,40751603950
009290,광동제약,6090,5960,-130,-2.13,3791542,23853536560
017040,광명전기,2445,2085,-360,-14.72,3864408,8672261040
017900,광전자,2280,2185,-95,-4.17,3505035,8420406800
037710,광주신세계,32950,32000,-950,-2.88,190212,6243219450
030610,교보증권,5860,5260,-600,-10.24,822643,4670466540
339770,교촌에프앤비,10500,9200,-1300,-12.38,974573,9894544320
007690,국도화학,45800,42750,-3050,-6.66,229189,10489196650
005320,국동,1245,1085,-160,-12.85,7853214,9853110355
001140,국보,993,728,-265,-26.69,22330610,19967517231
002720,국제약품,4400,5500,1100,25.0,77170943,460162411235
083420,그린케미칼,12750,9570,-3180,-24.94,12506697,147996924960
014530,극동유화,3760,3630,-130,-3.46,8211517,32626481700
014280,금강공업,7660,6190,-1470,-19.19,7425170,51274846610
014285,금강공업우,14300,11950,-2350,-16.43,62967,800538700
008870,금비,63600,109000,45400,71.38,4165799,419807427100
001570,금양,29150,23900,-5250,-18.01,76232435,2122022186550
002990,금호건설,8130,7000,-1130,-13.9,5089993,40890154790
002995,금호건설우,31000,21850,-9150,-29.52,86884,2395499000
011780,금호석유,149500,126000,-23500,-15.72,1324603,184575542000
011785,금호석유우,94200,81000,-13200,-14.01,215319,19419054500
214330,금호에이치티,1025,892,-133,-12.98,26467545,26844703988
001210,금호전기,1010,920,-90,-8.91,1727968,1687019752
073240,금호타이어,3010,2780,-230,-7.64,5431422,16150698740
092440,기신정기,3525,3430,-95,-2.7,612358,2140269120
000270,기아,68600,59300,-9300,-13.56,25720234,1640094186337
024110,기업은행,11200,9820,-1380,-12.32,31679708,342231088756
013700,까뮤이앤씨,2010,2130,120,5.97,42020209,89765493420
004540,깨끗한나라,3050,2800,-250,-8.2,977437,2972560535
004545,깨끗한나라우,17700,17550,-150,-0.85,6274,114729900
001260,남광토건,10500,8780,-1720,-16.38,2745439,28219854580
008350,남선알미늄,2550,2130,-420,-16.47,58396839,139140764895
008355,남선알미우,29000,27100,-1900,-6.55,100963,2860066550
004270,남성,2275,1930,-345,-15.16,2189843,4658411655
003920,남양유업,430000,489000,59000,13.72,47344,21394697000
003925,남양유업우,226000,242500,16500,7.3,4302,984201000
025860,남해화학,9150,8510,-640,-6.99,2935427,26111190720
005720,넥센,4145,4105,-40,-0.97,304097,1266501510
005725,넥센우,3735,3270,-465,-12.45,336981,1278384370
002350,넥센타이어,7000,6120,-880,-12.57,3172982,21927799490
002355,넥센타이어1우B,2970,2655,-315,-10.61,165498,481104705
251270,넷마블,48950,60400,11450,23.39,9771365,537513979450
090350,노루페인트,8380,7740,-640,-7.64,871322,7167452520
090355,노루페인트우,15000,15300,300,2.0,63611,1042879000
000320,노루홀딩스,10500,9970,-530,-5.05,441412,4653947890
000325,노루홀딩스우,23900,22200,-1700,-7.11,99672,2409665500
006280,녹십자,129000,129500,500,0.39,670110,90044046500
005250,녹십자홀딩스,17300,17000,-300,-1.73,2069102,37278339900
005257,녹십자홀딩스2우,38700,32950,-5750,-14.86,55523,1969246900
004370,농심,328500,357000,28500,8.68,383577,131449044500
072710,농심홀딩스,64500,66500,2000,3.1,39001,2617513200
058730,다스코,5820,4550,-1270,-21.82,14677068,82482813790
030210,다올투자증권,3260,2800,-460,-14.11,20907230,67368105965
023590,다우기술,20800,19200,-1600,-7.69,1299981,25666855600
145210,다이나믹디자인,7500,3590,-3910,-52.13,30648875,157623195925
019680,대교,2750,2615,-135,-4.91,570829,1502653940
019685,대교우B,1910,1685,-225,-11.78,118251,220862925
006370,대구백화점,10150,9820,-330,-3.25,97147,960101850
008060,대덕,6510,6210,-300,-4.61,1706370,11373984910
00806K,대덕1우,7610,9360,1750,23.0,405291,3689803760
353200,대덕전자,23200,18900,-4300,-18.53,6359958,135658873050
35320K,대덕전자1우,10500,9910,-590,-5.62,279312,3060573190
000490,대동,12600,12950,350,2.78,11548584,144457638350
008110,대동전자,11200,9320,-1880,-16.79,988936,10203526950
005750,대림BCo,4350,3770,-580,-13.33,462160,1849826210
006570,대림통상,3905,3570,-335,-8.58,206290,793514855
001680,대상,21300,21900,600,2.82,2341286,51567214800
001685,대상우,16100,15650,-450,-2.8,72739,1169582400
084690,대상홀딩스,7490,7740,250,3.34,858834,6709893500
084695,대상홀딩스우,9090,8980,-110,-1.21,81972,744760820
128820,대성산업,4360,3850,-510,-11.7,3677157,15053148570
117580,대성에너지,11450,9140,-2310,-20.17,5459925,60519904770
016710,대성홀딩스,113000,109500,-3500,-3.1,1525628,170288088000
003540,대신증권,14700,12900,-1800,-12.24,1470996,21069618700
003547,대신증권2우B,13150,11300,-1850,-14.07,538976,6906754550
003545,대신증권우,13650,11600,-2050,-15.02,1617161,21283891400
009190,대양금속,3455,3200,-255,-7.38,7835511,26578868915
014160,대영포장,1810,1530,-280,-15.47,16007641,27109428825
047040,대우건설,5090,4180,-910,-17.88,19221504,86916328105
009320,대우부품,1625,1440,-185,-11.38,8638275,12992596665
042660,대우조선해양,19100,18950,-150,-0.79,6436000,121639771800
003090,대웅,20300,20350,50,0.25,1019949,21420880900
069620,대웅제약,147500,158500,11000,7.46,997130,155420530500
000430,대원강업,3515,3390,-125,-3.56,5151852,18331164280
006340,대원전선,1275,1100,-175,-13.73,4774220,5621170800
006345,대원전선우,2500,2365,-135,-5.4,93595,229627400
003220,대원제약,17800,18750,950,5.34,13937612,272813765050
024890,대원화성,2680,2325,-355,-13.25,25572593,69372841695
002880,대유에이텍,723,711,-12,-1.66,4528506,3202733137
000300,대유플러스,891,750,-141,-15.82,6471034,5458528750
012800,대창,1305,1205,-100,-7.66,5081822,6489157260
015230,대창단조,9000,8090,-910,-10.11,12106224,102505012810
001070,대한방직,51000,51400,400,0.78,177285,9083865500
006650,대한유화,161500,171500,10000,6.19,1260385,209890649500
001440,대한전선,1690,1495,-195,-11.54,114207721,184370681035
084010,대한제강,12950,10850,-2100,-16.22,588535,7054483400
001790,대한제당,2730,2545,-185,-6.78,3808360,10314907895
001795,대한제당우,2440,2340,-100,-4.1,645992,1583778090
001130,대한제분,138000,132500,-5500,-3.99,37485,5099574000
003490,대한항공,25450,22950,-2500,-9.82,25904245,648245522400
003495,대한항공우,29400,30700,1300,4.42,541980,17551769600
005880,대한해운,2165,2175,10,0.46,22241678,48088008520
003830,대한화섬,118500,117000,-1500,-1.27,11837,1401136500
016090,대현,2410,2190,-220,-9.13,4959043,11722603230
069460,대호에이엘,1620,1300,-320,-19.75,9630565,14137079765
192080,더블유게임즈,48700,47250,-1450,-2.98,786729,38234538600
012510,더존비즈온,35950,36850,900,2.5,1544601,58458067200
004830,덕성,5260,5000,-260,-4.94,1533164,8040268125
004835,덕성우,6120,5810,-310,-5.07,295369,1833838390
024900,덕양산업,2785,2395,-390,-14.0,1454778,3731137235
145720,덴티움,88100,100000,11900,13.51,1562642,144466161500
002150,도화엔지니어링,9950,8210,-1740,-17.49,5719588,51873041100
001230,동국제강,13750,11150,-2600,-18.91,8086992,100031649050
023450,동남합성,52700,54400,1700,3.23,24993,1348772500
004140,동방,2970,2645,-325,-10.94,37233805,109242141450
007590,동방아그로,6490,6310,-180,-2.77,209883,1370020520
005960,동부건설,7880,7260,-620,-7.87,19038027,177051942330
005965,동부건설우,29700,28100,-1600,-5.39,607392,23554762600
026960,동서,21400,20200,-1200,-5.61,1113365,23352667750
002210,동성제약,6740,6680,-60,-0.89,564822,3829929550
102260,동성케미컬,4620,4730,110,2.38,1279279,6128727815
000640,동아쏘시오홀딩스,102000,101500,-500,-0.49,66936,6762260200
170900,동아에스티,59551,60800,1249,2.1,102083,6358904000
028100,동아지질,14850,12150,-2700,-18.18,316242,4267142700
282690,동아타이어,12200,11350,-850,-6.97,1014414,12489568100
001520,동양,1060,1000,-60,-5.66,4547154,4808866593
001527,동양2우B,13350,12600,-750,-5.62,66210,882121750
084670,동양고속,14350,13850,-500,-3.48,16447,240411500
082640,동양생명,5510,4860,-650,-11.8,3190273,17465751485
001525,동양우,6500,6390,-110,-1.69,64800,424905470
008970,동양철관,1060,943,-117,-11.04,7112974,7195723347
092780,동양피스톤,4850,4795,-55,-1.13,1486697,7524914275
049770,동원FB,138500,157000,18500,13.36,64845,9825562500
018500,동원금속,1095,1000,-95,-8.68,5835910,6123456546
006040,동원산업,47050,49350,2300,4.89,899234,45342158800
030720,동원수산,9730,8680,-1050,-10.79,541092,4993502200
014820,동원시스템즈,50700,40600,-10100,-19.92,477957,21739906100
014825,동원시스템즈우,30000,29400,-600,-2.0,2193,65605000
163560,동일고무벨트,7290,6200,-1090,-14.95,682095,4667737240
004890,동일산업,187500,185500,-2000,-1.07,187828,34651620500
002690,동일제강,2470,2070,-400,-16.19,1054207,2400520475
000020,동화약품,9020,9260,240,2.66,4047764,39644751810
000150,두산,97300,83100,-14200,-14.59,2486161,213824208600
000157,두산2우B,92000,81100,-10900,-11.85,12803,1139703400
241560,두산밥캣,35550,34600,-950,-2.67,9494641,336566001050
034020,두산에너빌리티,16750,15400,-1350,-8.06,76036171,1207626542950
000155,두산우,54100,47550,-6550,-12.11,52208,2636848100
336260,두산퓨얼셀,33600,29350,-4250,-12.65,6890741,221878346600
33626K,두산퓨얼셀1우,10250,9330,-920,-8.98,256826,2550354120
33626L,두산퓨얼셀2우B,12850,11700,-1150,-8.95,101428,1288622350
016740,두올,2590,2445,-145,-5.6,1298872,3374474750
192650,드림텍,9670,9100,-570,-5.89,7147304,71615278620
024090,디씨엠,14100,13550,-550,-3.9,482596,7035131750
003160,디아이,4810,4745,-65,-1.35,5983216,32839029565
092200,디아이씨,4145,3370,-775,-18.7,2580022,9775507705
377190,디앤디플랫폼리츠,3460,3405,-55,-1.59,1698948,5849283030
013570,디와이,6100,5300,-800,-13.11,1991783,11622335580
210540,디와이파워,13550,12250,-1300,-9.59,2755806,34613561850
115390,락앤락,6540,6270,-270,-4.13,1356444,8810723270
032350,롯데관광개발,11850,14450,2600,21.94,18048193,236514931600
089860,롯데렌탈,29050,27650,-1400,-4.82,722125,20589176650
330590,롯데리츠,3920,3990,70,1.79,3486630,14160331620
000400,롯데손해보험,1535,1415,-120,-7.82,2383831,3428979180
023530,롯데쇼핑,84500,91000,6500,7.69,1602256,142583034500
004000,롯데정밀화학,62500,56700,-5800,-9.28,1280824,76408371600
286940,롯데정보통신,23300,23500,200,0.86,488978,11411844600
280360,롯데제과,129000,122500,-6500,-5.04,338575,41752769500
004990,롯데지주,32850,30800,-2050,-6.24,2892267,93601238350
00499K,롯데지주우,44900,42400,-2500,-5.57,6459,280172950
005300,롯데칠성,157000,176000,19000,12.1,711779,120376430000
005305,롯데칠성우,72000,74600,2600,3.61,28497,2113667500
011170,롯데케미칼,174785,178500,3715,2.13,2759779,502671158000
071840,롯데하이마트,13400,12250,-1150,-8.58,734829,9845176200
027740,마니커,1290,1195,-95,-7.36,5196055,6390313305
357430,마스턴프리미어리츠,3650,3715,65,1.78,985036,3606119436
001080,만호제강,37650,29500,-8150,-21.65,453255,15532258050
088980,맥쿼리인프라,11300,11050,-250,-2.21,15912288,179864260400
094800,맵스리얼티1,4215,4005,-210,-4.98,945375,3947314980
138040,메리츠금융지주,37750,42700,4950,13.11,12632324,500017563700
008560,메리츠증권,5840,6240,400,6.85,31286453,186874897690
000060,메리츠화재,46000,49700,3700,8.04,4838778,226950595350
090370,메타랩스,3105,2445,-660,-21.26,1269799,3810242365
017180,명문제약,2700,2870,170,6.3,8733164,26971537735
009900,명신산업,17650,14350,-3300,-18.7,7120731,116939354200
012690,모나리자,3060,2850,-210,-6.86,5724098,17915288220
005360,모나미,3305,3175,-130,-3.93,1267475,4207103675
204210,모두투어리츠,4960,3715,-1245,-25.1,512079,2251930625
009680,모토닉,8400,8040,-360,-4.29,235664,1980031620
009580,무림PP,4615,4350,-265,-5.74,4416337,20071724015
009200,무림페이퍼,2775,2450,-325,-11.71,3454685,9099301655
033920,무학,5080,4935,-145,-2.85,1153836,5848261650
008420,문배철강,3735,3220,-515,-13.79,3593039,12546718615
025560,미래산업,12100,10850,-1250,-10.33,967650,12337838650
007120,미래아이앤지,307,280,-27,-8.79,12942207,3979137438
396690,미래에셋글로벌리츠,3700,3700,0,0.0,796244,3051331220
357250,미래에셋맵스리츠,3505,3470,-35,-1.0,439373,1534103410
085620,미래에셋생명,2820,2890,70,2.48,1544252,4467550680
006800,미래에셋증권,6650,6080,-570,-8.57,14961128,96471758560
00680K,미래에셋증권2우B,3810,3580,-230,-6.04,2302691,8647351920
006805,미래에셋증권우,4370,4040,-330,-7.55,197562,845232740
002840,미원상사,172000,166000,-6000,-3.49,43070,7361853500
268280,미원에스씨,149500,154000,4500,3.01,34262,5369822000
107590,미원홀딩스,112500,110000,-2500,-2.22,19824,2163583000
134380,미원화학,65000,68700,3700,5.69,19916,1365039700
003650,미창석유,73400,72900,-500,-0.68,22772,1669624100
155900,바다로19호,3030,2975,-55,-1.82,276903,829198425
003610,방림,7960,4780,-3180,-39.95,18789393,107838068600
001340,백광산업,4615,4310,-305,-6.61,8229780,37407299890
035150,백산,9010,8180,-830,-9.21,3200401,27772950040
002410,범양건영,4655,3380,-1275,-27.39,8849560,36371795265
096300,베트남개발1,271,180,-91,-33.58,519926372,119321341387
007210,벽산,2200,2020,-180,-8.18,2757291,5970396570
002760,보락,1495,1610,115,7.69,66186110,118737302145
003850,보령,10650,9060,-1590,-14.93,5479034,56421352890
000890,보해양조,660,617,-43,-6.52,4090637,2632002716
003000,부광약품,8040,8750,710,8.83,14583664,134043322980
001270,부국증권,19350,18150,-1200,-6.2,86323,1642482350
001275,부국증권우,19100,18000,-1100,-5.76,30719,585203950
026940,부국철강,3775,3205,-570,-15.1,3733299,13498039885
011390,부산산업,87100,72500,-14600,-16.76,137024,11355022700
005030,부산주공,699,643,-56,-8.01,29786657,21198430140
002070,비비안,1415,1270,-145,-10.25,10189783,15701756685
100220,비상교육,5910,5850,-60,-1.02,585104,3626123390
030790,비케이탑스,904,904,0,0.0,0,0
005180,빙그레,39450,39250,-200,-0.51,205558,8314869700
003960,사조대림,25450,27150,1700,6.68,294981,7782222850
008040,사조동아원,1025,902,-123,-12.0,17621922,17533324685
007160,사조산업,41350,45000,3650,8.83,198697,8775564800
014710,사조씨푸드,4860,4525,-335,-6.89,1863366,8937305240
006090,사조오양,7960,7990,30,0.38,223316,1797308430
001470,삼부토건,1535,1240,-295,-19.22,29587943,43111774975
006400,삼성SDI,729000,591000,-138000,-18.93,4418608,2909548909547
006405,삼성SDI우,342500,277000,-65500,-19.12,119369,36042634500
006660,삼성공조,10600,9750,-850,-8.02,156655,1599746010
028260,삼성물산,122000,113500,-8500,-6.97,4483377,529626308910
02826K,삼성물산우B,110500,102000,-8500,-7.69,52534,5690922000
207940,삼성바이오로직스,887000,821000,-66000,-7.44,912808,759460994100
032830,삼성생명,73400,71000,-2400,-3.27,6116407,442250357422
018260,삼성에스디에스,127500,123000,-4500,-3.53,1306654,165071307500
028050,삼성엔지니어링,24550,22250,-2300,-9.37,16367303,378615417850
009150,삼성전기,141000,130500,-10500,-7.45,7752906,1065326986500
009155,삼성전기우,68800,64000,-4800,-6.98,76682,5187509300
005930,삼성전자,62200,55300,-6900,-11.09,234543029,13896903814919
005935,삼성전자우,55900,50500,-5400,-9.66,13711304,737199693127
001360,삼성제약,2830,2685,-145,-5.12,5389099,15809387750
010140,삼성중공업,5210,5110,-100,-1.92,50200054,258344757190
010145,삼성중공우,189000,123500,-65500,-34.66,18654,3046461500
016360,삼성증권,35200,31450,-3750,-10.65,5564527,191805595400
068290,삼성출판사,27700,24200,-3500,-12.64,1917194,51139776500
029780,삼성카드,32300,29550,-2750,-8.51,1958750,62688306450
000810,삼성화재,205500,200000,-5500,-2.68,1883650,390216180796
000815,삼성화재우,164500,153000,-11500,-6.99,206672,33638612000
006110,삼아알미늄,32550,41400,8850,27.19,18335937,705498269550
145990,삼양사,39150,38550,-600,-1.53,246401,10093131400
145995,삼양사우,31600,29500,-2100,-6.65,13799,406532200
003230,삼양식품,111500,127000,15500,13.9,1329350,162616848000
002170,삼양통상,52500,52800,300,0.57,18441,969790400
272550,삼양패키징,17600,18650,1050,5.97,191576,3488350300
000070,삼양홀딩스,66600,68700,2100,3.15,404477,27849457300
000075,삼양홀딩스우,56800,55500,-1300,-2.29,7351,417085200
002810,삼영무역,13000,12450,-550,-4.23,261931,3405215900
005680,삼영전자,9610,9300,-310,-3.23,665911,6323893710
003720,삼영화학,2625,2410,-215,-8.19,5109318,13779309700
023000,삼원강재,2860,2670,-190,-6.64,2534120,7547633910
004380,삼익THK,13050,11850,-1200,-9.2,506958,6340762150
002450,삼익악기,1300,1285,-15,-1.15,4367817,5813134660
004440,삼일씨엔에스,6420,5600,-820,-12.77,240544,1491622180
000520,삼일제약,7700,8580,880,11.43,29841056,263241418100
009770,삼정펄프,26250,25500,-750,-2.86,75150,1970381050
005500,삼진제약,26050,25650,-400,-1.54,3308044,89308949850
004690,삼천리,380500,391000,10500,2.76,924047,353053853000
010960,삼호개발,4090,3820,-270,-6.6,1026910,4276589635
004450,삼화왕관,37150,36850,-300,-0.81,1436984,61216535100
009470,삼화전기,15750,13700,-2050,-13.02,139248,2077223150
011230,삼화전자,2800,2890,90,3.21,327136,916056660
001820,삼화콘덴서,34800,30000,-4800,-13.79,645248,21236903800
000390,삼화페인트,6270,5880,-390,-6.22,503679,3104426530
001290,상상인증권,859,760,-99,-11.53,3181919,2625440523
041650,상신브레이크,3200,3025,-175,-5.47,819357,2783357580
075180,새론오토모티브,5080,5060,-20,-0.39,367555,1914066260
007540,샘표,47350,47400,50,0.11,383686,18603013200
248170,샘표식품,33550,34750,1200,3.58,192376,6535014950
007860,서연,8160,6930,-1230,-15.07,6729448,52623835150
200880,서연이화,9260,7860,-1400,-15.12,4661890,42711321800
017390,서울가스,408500,425000,16500,4.04,320651,132211782000
004410,서울식품,219,201,-18,-8.22,25382047,5489855972
004415,서울식품우,2770,2710,-60,-2.17,38966,110134715
021050,서원,1430,1175,-255,-17.83,2267734,2961643920
008490,서흥,32500,33650,1150,3.54,300318,10091101900
007610,선도전기,3000,3000,0,0.0,0,0
136490,선진,8550,9300,750,8.77,1566623,14297744380
014910,성문전자,1810,1550,-260,-14.36,3952489,6841518885
014915,성문전자우,8450,8000,-450,-5.33,11746,96216320
003080,성보화학,3610,3275,-335,-9.28,1133761,3855501550
004980,성신양회,11300,9540,-1760,-15.58,7449904,82189857050
004985,성신양회우,14400,12500,-1900,-13.19,617179,8546108900
011300,성안,907,890,-17,-1.87,9208733,8113939192
000180,성창기업지주,2045,1860,-185,-9.05,1488029,2977919870
002420,세기상사,8050,7570,-480,-5.96,459760,3964699650
004360,세방,26450,29800,3350,12.67,7983000,228372346200
004365,세방우,9010,8120,-890,-9.88,337615,2887284580
004490,세방전지,48450,42350,-6100,-12.59,1742596,82829765250
001430,세아베스틸지주,19250,16300,-2950,-15.32,2829131,52895267500
306200,세아제강,150000,129500,-20500,-13.67,222870,31765736000
003030,세아제강지주,174000,146500,-27500,-15.8,342921,54061119000
019440,세아특수강,21000,17150,-3850,-18.33,1068289,20480476500
058650,세아홀딩스,108000,108000,0,0.0,6666,725032000
013000,세우글로벌,2110,1640,-470,-22.27,18616699,36276921730
091090,세원이앤씨,818,560,-258,-31.54,161721360,118360745054
021820,세원정공,9310,6150,-3160,-33.94,3036952,21247263010
067830,세이브존IC,2725,2500,-225,-8.26,380941,999041635
033530,세종공업,5910,5480,-430,-7.28,7677334,48226725140
075580,세진중공업,5860,5150,-710,-12.12,3734540,20861235170
027970,세하,1290,1125,-165,-12.79,2363909,2887367290
308170,센트랄모텍,17550,13000,-4550,-25.93,2201565,33648108000
012600,센트럴인사이트,2490,2490,0,0.0,0,0
068270,셀트리온,169537,160500,-9037,-5.33,6763403,1184447143500
336370,솔루스첨단소재,38850,30000,-8850,-22.78,2241819,74750779850
33637K,솔루스첨단소재1우,9780,7980,-1800,-18.4,184985,1596647180
33637L,솔루스첨단소재2우B,11450,9980,-1470,-12.84,34968,371260730
248070,솔루엠,18100,17400,-700,-3.87,1925526,33343774700
004430,송원산업,17600,17200,-400,-2.27,2280482,39948006100
126720,수산인더스트리,22450,22000,-450,-2.0,1197516,27036228300
017550,수산중공업,3245,2665,-580,-17.87,11942567,35828927920
053210,스카이라이프,8590,8140,-450,-5.24,1890760,16467796790
026890,스틱인베스트먼트,5940,5160,-780,-13.13,6307494,38441854180
134790,시디즈,43100,39250,-3850,-8.93,104111,4329776100
016590,신대양제지,84600,86000,1400,1.65,51119,4348451400
029530,신도리코,34500,32350,-2150,-6.23,270651,9192088000
004970,신라교역,11500,11300,-200,-1.74,519951,6069587600
011930,신성이엔지,1925,1555,-370,-19.22,21079153,37181813500
005390,신성통상,2450,2235,-215,-8.78,2728032,6367948845
004170,신세계,210500,220000,9500,4.51,1830442,403452764500
035510,신세계IC,14400,13750,-650,-4.51,2688377,39360635650
034300,신세계건설,18050,16550,-1500,-8.31,372848,7132595100
031430,신세계인터내셔날,24150,24750,600,2.48,3696522,96319398400
031440,신세계푸드,49900,48050,-1850,-3.71,123210,6117001400
006880,신송홀딩스,7070,5990,-1080,-15.28,7712351,57091827640
005800,신영와코루,11600,11150,-450,-3.88,115285,1282719800
001720,신영증권,58000,57100,-900,-1.55,39365,2270684500
001725,신영증권우,57300,57500,200,0.35,26183,1499031500
009270,신원,1650,1545,-105,-6.36,10849260,17738805805
002700,신일전자,1920,1860,-60,-3.13,8953157,17014697580
002870,신풍,1360,1150,-210,-15.44,1345431,1744757120
019170,신풍제약,21650,21150,-500,-2.31,10904930,249185609250
019175,신풍제약우,41500,41550,50,0.12,1282340,69562446100
404990,신한서부티엔디리츠,3780,3645,-135,-3.57,928026,3498811920
293940,신한알파리츠,6860,6570,-290,-4.23,1148068,7622637520
055550,신한지주,38100,35200,-2900,-7.61,22631657,852288001750
004080,신흥,15050,14800,-250,-1.66,32561,485550650
102280,쌍방울,383,317,-66,-17.23,30335609,10858356538
003410,쌍용CE,5970,5760,-210,-3.52,9850760,58903778920
003620,쌍용차,8760,8760,0,0.0,0,0
004770,써니전자,2465,2595,130,5.27,18230990,47897632515
015540,쎌마테라퓨틱스,6410,6410,0,0.0,0,0
403550,쏘카,19150,21750,2600,13.58,5756057,124126828850
004920,씨아이테크,911,876,-35,-3.84,8784258,8323334917
112610,씨에스윈드,76500,68800,-7700,-10.07,4675297,337801274000
008700,아남전자,1885,1670,-215,-11.41,6331060,11582698410
002790,아모레G,31650,34900,3250,10.27,13011813,441381803550
00279K,아모레G3우전환,26400,28000,1600,6.06,77562,2107594750
002795,아모레G우,12900,13800,900,6.98,315389,4281173500
090430,아모레퍼시픽,130500,137500,7000,5.36,6130175,825426505132
090435,아모레퍼시픽우,49900,48300,-1600,-3.21,306540,14714905800
002030,아세아,133000,131500,-1500,-1.13,48122,6385681000
183190,아세아시멘트,10100,9260,-840,-8.32,1260268,12498079890
002310,아세아제지,38800,39400,600,1.55,660870,25980184550
012170,아센디오,928,829,-99,-10.67,2049812,1837835128
267850,아시아나IDT,16300,15900,-400,-2.45,10684320,186362521900
020560,아시아나항공,12600,14000,1400,11.11,9410454,126542305800
122900,아이마켓코리아,10300,10100,-200,-1.94,782582,8156818000
010780,아이에스동서,34150,28200,-5950,-17.42,2132733,63821943550
139990,아주스틸,9310,9290,-20,-0.21,1475663,15031757880
001780,알루코,3130,2585,-545,-17.41,44785681,135053721955
018250,애경산업,16500,20900,4400,26.67,5654314,111100548950
161000,애경케미칼,9660,8870,-790,-8.18,3580265,33172753510
011090,에넥스,929,768,-161,-17.33,3104637,2772894758
137310,에스디바이오센서,32900,30150,-2750,-8.36,7244473,234443904212
005850,에스엘,27900,22950,-4950,-17.74,3943673,100063522400
010580,에스엠벡셀,2315,1745,-570,-24.62,4006381,8031037140
012750,에스원,64200,59300,-4900,-7.63,1019060,64010689516
023960,에쓰씨엔지니어링,1920,1595,-325,-16.93,2018334,3541982485
298690,에어부산,2150,2725,575,26.74,24923221,64220665900
140910,에이리츠,4085,4095,10,0.24,70067,296094270
078520,에이블씨엔씨,5070,5240,170,3.35,1509503,8047579930
015260,에이엔피,1725,1610,-115,-6.67,2411709,3992211545
007460,에이프로젠,681,572,-109,-16.01,322100067,223257281416
003060,에이프로젠제약,506,503,-3,-0.59,54377697,29523730662
244920,에이플러스에셋,5100,4840,-260,-5.1,826762,4151155120
036570,엔씨소프트,470500,448000,-22500,-4.78,1818109,814850420718
380440,엔에이치스팩19호,1975,1955,-20,-1.01,1773630,3460811290
085310,엔케이,968,870,-98,-10.12,2008093,1856830872
900140,엘브이엠씨홀딩스,2960,2630,-330,-11.15,5649638,16019865870
097520,엠씨넥스,29500,27900,-1600,-5.42,695526,19786698950
014440,영보화학,3705,3420,-285,-7.69,499101,1781774120
111770,영원무역,47500,46950,-550,-1.16,1942660,90475416305
009970,영원무역홀딩스,56900,61400,4500,7.91,494190,30070711300
003520,영진약품,3260,3250,-10,-0.31,94715379,341649605045
000670,영풍,765000,605000,-160000,-20.92,96696,66083705000
006740,영풍제지,15000,12300,-2700,-18.0,11088738,150388034550
012280,영화금속,922,796,-126,-13.67,1435625,1248889532
012160,영흥,747,709,-38,-5.09,1713897,1284183229
015360,예스코홀딩스,33800,31500,-2300,-6.8,108765,3610619400
007310,오뚜기,445500,476000,30500,6.85,77421,35995518500
002630,오리엔트바이오,643,613,-30,-4.67,5342577,3437187614
271560,오리온,117500,128000,10500,8.94,2343284,282964455684
001800,오리온홀딩스,15300,15350,50,0.33,1602322,25218185950
011690,와이투솔루션,680,594,-86,-12.65,9064476,5615319843
070960,용평리조트,3640,3530,-110,-3.02,4932044,19136129335
316140,우리금융지주,13000,11550,-1450,-11.15,51933848,655678272657
010050,우리종금,786,744,-42,-5.34,22427900,17443903522
006980,우성,23800,21500,-2300,-9.66,199818,4706083200
017370,우신시스템,3250,3200,-50,-1.54,1783561,5868774770
105840,우진,9420,8380,-1040,-11.04,7400593,67464030430
010400,우진아이엔에스,5520,5110,-410,-7.43,807467,4620849170
049800,우진플라임,4020,3530,-490,-12.19,805447,3037755680
016880,웅진,1220,1185,-35,-2.87,3796269,4491009365
095720,웅진씽크빅,2675,2400,-275,-10.28,1203423,3042037935
005820,원림,20250,20550,300,1.48,127807,2730496850
010600,웰바이오텍,1295,1065,-230,-17.76,8677764,10670006830
008600,윌비스,770,689,-81,-10.52,1753939,1287422589
033270,유나이티드제약,23000,22750,-250,-1.09,1382498,34210740650
014830,유니드,98500,81400,-17100,-17.36,611759,56434277400
446070,유니드비티플러스,6360,8400,2040,32.08,54228196,455061812290
000910,유니온,5170,4705,-465,-8.99,1419773,7170036910
047400,유니온머티리얼,2900,2460,-440,-15.17,16666255,47711883695
011330,유니켐,1280,1215,-65,-5.08,3715916,4775243335
077500,유니퀘스트,8750,8250,-500,-5.71,1424101,12443275100
002920,유성기업,2950,2675,-275,-9.32,703120,1997066170
000700,유수홀딩스,7170,6400,-770,-10.74,1977554,14708916190
003470,유안타증권,2700,2395,-305,-11.3,15102854,40986792535
003475,유안타증권우,2795,2365,-430,-15.38,3750717,10465599625
072130,유엔젤,3250,3010,-240,-7.38,12757883,45653700465
000220,유유제약,6190,6220,30,0.48,2838902,18572208080
000225,유유제약1우,7930,7680,-250,-3.15,232846,1872947120
000227,유유제약2우B,15050,15050,0,0.0,10350,161003350
001200,유진투자증권,2770,2340,-430,-15.52,1990001,5147102060
000100,유한양행,55865,57200,1335,2.39,3900893,231202101200
000105,유한양행우,54545,54600,55,0.1,23239,1335816700
003460,유화증권,2355,2230,-125,-5.31,923469,2121307615
003465,유화증권우,2500,2460,-40,-1.6,8395,20447875
008730,율촌화학,32750,36450,3700,11.3,6099105,215331556800
008250,이건산업,7910,7140,-770,-9.73,934874,7167311880
025820,이구산업,3095,3130,35,1.13,8852270,27594300975
214320,이노션,43550,41150,-2400,-5.51,330552,14138827550
088260,이리츠코크렙,5440,5200,-240,-4.41,725443,3869774300
139480,이마트,92100,98000,5900,6.41,3376820,338205746000
007660,이수페타시스,6330,5630,-700,-11.06,15263960,94168374270
005950,이수화학,23800,18200,-5600,-23.53,16828507,370742307150
015020,이스타코,994,820,-174,-17.51,2289016,2157184382
093230,이아이디,1015,862,-153,-15.07,5693279,5544953097
074610,이엔플러스,7430,4725,-2705,-36.41,117300175,702924831255
102460,이연제약,19700,21650,1950,9.9,7172025,165753527950
084680,이월드,1670,1510,-160,-9.58,2241055,3646372495
350520,이지스레지던스리츠,4045,3905,-140,-3.46,586280,2372483065
334890,이지스밸류리츠,4600,4840,240,5.22,463415,2152530020
000760,이화산업,16350,15750,-600,-3.67,27793,456804100
014990,인디에프,1795,1510,-285,-15.88,105735783,168018437485
101140,인바이오젠,985,775,-210,-21.32,10711228,10212791245
006490,인스코비,1630,1290,-340,-20.86,13525034,20564532560
023800,인지컨트롤스,8690,6990,-1700,-19.56,925119,7359826340
034590,인천도시가스,29500,27900,-1600,-5.42,313177,9335206050
129260,인터지스,3025,2800,-225,-7.44,2763574,8545990730
023810,인팩,7340,6660,-680,-9.26,322518,2259370010
249420,일동제약,38400,28550,-9850,-25.65,54058308,2135263431550
000230,일동홀딩스,31150,20150,-11000,-35.31,12832712,362265382750
013360,일성건설,2780,2140,-640,-23.02,21879248,64489597820
003120,일성신약,90600,84400,-6200,-6.84,67789,6084117000
003200,일신방직,100000,103000,3000,3.0,148430,15630773100
007110,일신석재,1230,1020,-210,-17.07,4511693,5164542680
007570,일양약품,17400,19350,1950,11.21,7848682,158795126150
007575,일양약품우,20800,21100,300,1.44,38143,850186000
008500,일정실업,18750,16400,-2350,-12.53,33691,592774850
081000,일진다이아,17200,16600,-600,-3.49,485062,8419735200
020760,일진디스플,1370,1205,-165,-12.04,1697115,2193746635
020150,일진머티리얼즈,61900,51900,-10000,-16.16,4373373,247938927100
103590,일진전기,5710,5310,-400,-7.01,6024380,32824183640
271940,일진하이솔루스,33350,29850,-3500,-10.49,864992,27643099150
015860,일진홀딩스,4440,3820,-620,-13.96,2077906,8663982020
226320,잇츠한불,17350,17850,500,2.88,3966044,72590539350
317400,자이에스앤디,6290,6030,-260,-4.13,1992073,12704682480
033240,자화전자,24350,21250,-3100,-12.73,4057922,90329881300
000950,전방,49650,44450,-5200,-10.47,46581,2198987900
348950,제이알글로벌리츠,4320,4210,-110,-2.55,7421136,32392386365
194370,제이에스코퍼레이션,14700,13400,-1300,-8.84,817529,11501586550
025620,제이준코스메틱,7490,6030,-1460,-19.49,731443,4686311880
030000,제일기획,24250,23050,-1200,-4.95,6373408,150763600991
271980,제일약품,19000,21000,2000,10.53,6587236,145972178900
001560,제일연마,8510,8650,140,1.65,237342,2099708520
002620,제일파마홀딩스,10250,15400,5150,50.24,11788273,166772145350
006220,제주은행,11050,10650,-400,-3.62,141979053,1595167216850
089590,제주항공,10950,14900,3950,36.07,27368337,368274216500
004910,조광페인트,9050,7520,-1530,-16.91,606149,4988985020
004700,조광피혁,52600,49200,-3400,-6.46,20813,1038486000
001550,조비,15500,15300,-200,-1.29,219013,3341955650
000480,조선내화,79200,75800,-3400,-4.29,29094,2311377200
120030,조선선재,111000,99700,-11300,-10.18,121531,12755651900
018470,조일알미늄,2100,2355,255,12.14,308009596,785576971455
002600,조흥,194000,202500,8500,4.38,5426,1105991500
185750,종근당,79916,82100,2184,2.73,349558,30765075000
063160,종근당바이오,23300,23800,500,2.15,437792,10994862150
001630,종근당홀딩스,55200,53000,-2200,-3.99,43926,2440609800
044380,주연테크,855,806,-49,-5.73,20071569,17057661079
013890,지누스,32200,35000,2800,8.7,1474935,52818873850
013870,지엠비코리아,5150,4450,-700,-13.59,650520,3241770845
071320,지역난방공사,28000,28500,500,1.79,63743,1801103100
035000,지투알,6110,5900,-210,-3.44,155941,948426820
088790,진도,2795,2635,-160,-5.72,1004331,2824570985
003780,진양산업,6450,6240,-210,-3.26,2108344,14122511570
010640,진양폴리,5260,4420,-840,-15.97,1270031,6410700145
100250,진양홀딩스,3390,3025,-365,-10.77,846902,2760372690
051630,진양화학,3840,3595,-245,-6.38,926106,3538538895
272450,진에어,13700,16450,2750,20.07,8700964,136874535150
011000,진원생명과학,6970,7140,170,2.44,29195768,242644749910
002780,진흥기업,1340,1275,-65,-4.85,126339611,197104518655
002787,진흥기업2우B,13750,13000,-750,-5.45,110787,1736961800
002785,진흥기업우B,4800,4935,135,2.81,345243,1960080650
009310,참엔지니어링,850,710,-140,-16.47,2673664,2103441311
000650,천일고속,60500,60500,0,0.0,4680,282383800
033250,체시스,977,896,-81,-8.29,2759488,2765006390
118000,초록뱀헬스케어,592,520,-72,-12.16,39869906,27721156059
035720,카카오,56400,53100,-3300,-5.85,33393351,1875076493800
323410,카카오뱅크,25050,24300,-750,-2.99,195815255,5199245365200
377300,카카오페이,52900,54200,1300,2.46,30676375,1889302499900
006380,카프로,2210,1960,-250,-11.31,1850701,3859428790
109070,컨버즈,4100,4100,0,0.0,0,0
001620,케이비아이동국실업,640,610,-30,-4.69,1959714,1271130228
029460,케이씨,18150,17050,-1100,-6.06,446081,7918787850
281820,케이씨텍,16500,14800,-1700,-10.3,412191,6602626000
381970,케이카,14250,11550,-2700,-18.95,31236984,435828505500
145270,케이탑리츠,917,885,-32,-3.49,1450125,1356956831
417310,코람코더원리츠,4575,4270,-305,-6.67,730404,3202491365
357120,코람코에너지리츠,4955,5370,415,8.38,1917703,9787274745
007815,코리아써우,7580,6820,-760,-10.03,61987,457148150
007810,코리아써키트,14350,12000,-2350,-16.38,3455291,45772003350
00781K,코리아써키트2우B,8680,8130,-550,-6.34,4784,39579200
003690,코리안리,7181,6810,-371,-5.17,4833849,36560876010
192820,코스맥스,60800,74100,13300,21.88,2474968,168465872200
044820,코스맥스비티아이,8560,8870,310,3.62,415496,3715543160
005070,코스모신소재,63200,51800,-11400,-18.04,8655919,484919489200
005420,코스모화학,23000,20550,-2450,-10.65,13673464,299561874850
071950,코아스,797,730,-67,-8.41,3207879,2671749578
002020,코오롱,24700,21900,-2800,-11.34,531402,12453762800
003070,코오롱글로벌,28100,18750,-9350,-33.27,11234488,260375000050
003075,코오롱글로벌우,58400,36400,-22000,-37.67,996304,44645736600
002025,코오롱우,18500,16750,-1750,-9.46,339989,6231529950
120110,코오롱인더,45900,41150,-4750,-10.35,1890320,82987292300
120115,코오롱인더우,25000,23800,-1200,-4.8,92988,2283350000
138490,코오롱플라스틱,10200,8740,-1460,-14.31,2082040,19924919530
021240,코웨이,57600,55900,-1700,-2.95,3015349,172314665113
036420,콘텐트리중앙,27200,28550,1350,4.96,9674963,303263835950
031820,콤텍시스템,689,607,-82,-11.9,7138498,4747307605
192400,쿠쿠홀딩스,16150,16450,300,1.86,322217,5334057900
284740,쿠쿠홈시스,32200,29400,-2800,-8.7,349138,11088812200
015590,큐로,364,343,-21,-5.77,6260868,2238305290
264900,크라운제과,8610,8500,-110,-1.28,787211,6963026550
26490K,크라운제과우,11450,10700,-750,-6.55,137540,1581180300
005740,크라운해태홀딩스,6820,6790,-30,-0.44,1305205,9270790690
005745,크라운해태홀딩스우,10750,10700,-50,-0.47,21895,238164450
259960,크래프톤,227000,168000,-59000,-25.99,5718736,1061317424000
020120,키다리스튜디오,8710,9150,440,5.05,63443709,628569780250
039490,키움증권,92000,84000,-8000,-8.7,915823,82230621700
014580,태경비케이,7360,5200,-2160,-29.35,21598873,132551536050
015890,태경산업,7220,6480,-740,-10.25,1707921,11597418000
006890,태경케미컬,11150,10750,-400,-3.59,961754,10507708900
003240,태광산업,740000,746000,6000,0.81,16373,12160795000
011280,태림포장,3295,2865,-430,-13.05,9277634,30435020535
004100,태양금속,1575,1445,-130,-8.25,16528491,26339785730
004105,태양금속우,2700,2325,-375,-13.89,546856,1481054970
009410,태영건설,4965,4030,-935,-18.83,13571098,69424987105
009415,태영건설우,8490,6690,-1800,-21.2,213867,1876752860
001420,태원물산,4025,3895,-130,-3.23,178327,715955550
007980,태평양물산,1800,1715,-85,-4.72,159047065,326473053460
055490,테이팩스,60600,52400,-8200,-13.53,399853,22174698900
078000,텔코웨어,8670,8750,80,0.92,190763,1749895020
214420,토니모리,3860,4395,535,13.86,8252605,36503685455
019180,티에이치엔,3735,3495,-240,-6.43,2104053,7861612885
363280,티와이홀딩스,12250,10450,-1800,-14.69,1322330,15201075750
36328K,티와이홀딩스우,12450,10800,-1650,-13.25,34009,400723900
091810,티웨이항공,1845,2475,630,34.15,26299622,60718096160
004870,티웨이홀딩스,533,525,-8,-1.5,9667377,5292295043
005690,파미셀,10150,11300,1150,11.33,15170751,171311096850
036580,팜스코,3990,3900,-90,-2.26,7046250,29838821720
004720,팜젠사이언스,7020,6680,-340,-4.84,4810479,35249950360
028670,팬오션,5390,5730,340,6.31,68051099,394003199010
010820,퍼스텍,2895,3280,385,13.3,126075360,424446551070
016800,퍼시스,30000,30400,400,1.33,25077,753170700
001020,페이퍼코리아,1275,1095,-180,-14.12,2530317,3047374410
090080,평화산업,1410,1175,-235,-16.67,4093484,5284498485
010770,평화홀딩스,5010,3750,-1260,-25.15,5163186,23349139440
058430,포스코스틸리온,40000,32200,-7800,-19.5,5802539,242676204500
047050,포스코인터내셔널,24000,22600,-1400,-5.83,11167110,265400619650
003670,포스코케미칼,218500,180000,-38500,-17.62,12528245,2427941213110
017810,풀무원,11050,11200,150,1.36,791068,9001436600
103140,풍산,30400,33650,3250,10.69,3470261,112585829550
005810,풍산홀딩스,27750,28300,550,1.98,388361,11059973250
950210,프레스티지바이오파마,8170,7330,-840,-10.28,2525667,22088377030
009810,플레이그램,869,800,-69,-7.94,8668819,7173767685
086790,하나금융지주,44550,42050,-2500,-5.61,23672636,1065815315134
293480,하나제약,15850,18250,2400,15.14,6246490,110480562350
039130,하나투어,51400,60500,9100,17.7,3869630,223356753000
352820,하이브,143000,173500,30500,21.33,4768146,771465452500
071090,하이스틸,4405,3300,-1105,-25.09,3635603,14575450820
019490,하이트론,2470,2470,0,0.0,0,0
000080,하이트진로,26150,25550,-600,-2.29,3465723,92170522210
000087,하이트진로2우B,16200,16600,400,2.47,26275,442170300
000140,하이트진로홀딩스,10350,9720,-630,-6.09,542765,5514859610
000145,하이트진로홀딩스우,12950,13200,250,1.93,4006,53535600
152550,한국ANKOR유전,22,278,256,1163.64,71753094,14879599986
036460,한국가스공사,34900,36200,1300,3.72,8486727,310236320750
005430,한국공항,39650,40250,600,1.51,159526,6321693850
071050,한국금융지주,57700,53300,-4400,-7.63,3143256,181273245300
071055,한국금융지주우,48050,43100,-4950,-10.3,307145,14467663750
010040,한국내화,2940,2815,-125,-4.25,6845444,22491027465
025540,한국단자,58000,51800,-6200,-10.69,188804,10255716900
004090,한국석유,11350,10300,-1050,-9.25,2362079,27310131550
002200,한국수출포장,29100,28750,-350,-1.2,867837,26305306400
002960,한국쉘석유,251000,233500,-17500,-6.97,50439,12510241500
000240,한국앤컴퍼니,14350,13950,-400,-2.79,1819543,25165520850
123890,한국자산신탁,3265,2985,-280,-8.58,2448209,7977547880
015760,한국전력,20700,21800,1100,5.31,38290218,813953071700
006200,한국전자홀딩스,1200,1000,-200,-16.67,3164522,3532055598
009540,한국조선해양,78300,70700,-7600,-9.71,2776460,204127191400
023350,한국종합기술,8010,6710,-1300,-16.23,3342395,24455518950
025890,한국주강,2400,2560,160,6.67,11853690,34777545970
000970,한국주철관,7340,6780,-560,-7.63,496080,3518079080
104700,한국철강,6720,6090,-630,-9.38,995600,6489056970
017960,한국카본,11900,11050,-850,-7.14,7612350,87934080100
161890,한국콜마,38750,42600,3850,9.94,2288589,96586262350
024720,한국콜마홀딩스,15400,15750,350,2.27,336365,5346193500
161390,한국타이어앤테크놀로지,34000,31150,-2850,-8.38,4767594,158516165360
034830,한국토지신탁,1395,1310,-85,-6.09,22163275,31476716335
007280,한국특강,2100,1945,-155,-7.38,1152885,2285922230
168490,한국패러랠,2040,2055,15,0.74,1054893,2157861610
010100,한국프랜지,2890,2700,-190,-6.57,1207484,3422067395
047810,한국항공우주,48500,50900,2400,4.95,17334208,842702667250
123690,한국화장품,8000,8140,140,1.75,9841189,83150779110
003350,한국화장품제조,22400,28550,6150,27.46,4833439,131616082400
011500,한농화성,12550,9970,-2580,-20.56,1698945,18956960860
002390,한독,16350,16750,400,2.45,394762,6594379600
053690,한미글로벌,36300,26900,-9400,-25.9,10270857,317066285550
042700,한미반도체,13400,11500,-1900,-14.18,6019520,76257934400
008930,한미사이언스,30826,32450,1624,5.27,2142208,73634583700
128940,한미약품,256815,298000,41185,16.04,808758,231889080000
009240,한샘,46950,44600,-2350,-5.01,859873,39623989300
020000,한섬,25850,27050,1200,4.64,1308145,35600372500
003680,한성기업,5550,5140,-410,-7.39,621812,3463567930
105630,한세실업,15850,15400,-450,-2.84,4161105,67192798800
069640,한세엠케이,3000,2965,-35,-1.17,594696,1962433480
016450,한세예스24홀딩스,5060,4625,-435,-8.6,376085,1905752645
010420,한솔PNS,1850,1560,-290,-15.68,1570550,2650093075
009180,한솔로지스틱스,3025,2820,-205,-6.78,3082562,9049250170
213500,한솔제지,13950,13250,-700,-5.02,2141370,29927167450
014680,한솔케미칼,210000,185500,-24500,-11.67,677118,135320948600
004710,한솔테크닉스,5630,5100,-530,-9.41,1295440,7329221570
004150,한솔홀딩스,3375,3270,-105,-3.11,1690034,5674383820
025750,한솔홈데코,1185,1025,-160,-13.5,6581871,7440742245
004960,한신공영,10200,8490,-1710,-16.76,4305372,45553805530
011700,한신기계,7100,6400,-700,-9.86,11480187,79480681240
001750,한양증권,9260,8210,-1050,-11.34,427085,3926772330
001755,한양증권우,12600,12850,250,1.98,300070,4464249300
018880,한온시스템,8700,8090,-610,-7.01,11417195,96608081590
009420,한올바이오파마,14250,17800,3550,24.91,4071352,66764344000
014130,한익스프레스,5370,5260,-110,-2.05,1470843,8344334080
300720,한일시멘트,12300,11650,-650,-5.28,1321734,16310111150
002220,한일철강,3290,2815,-475,-14.44,747612,2324030525
006390,한일현대시멘트,20550,17500,-3050,-14.84,224462,4337324050
003300,한일홀딩스,11550,10800,-750,-6.49,128680,1432962250
051600,한전KPS,34500,33200,-1300,-3.77,2636020,91084735500
052690,한전기술,60600,54600,-6000,-9.9,3930581,226438343100
130660,한전산업,9340,8510,-830,-8.89,3506528,32310642010
002320,한진,20450,21050,600,2.93,588883,12168940900
003480,한진중공업홀딩스,4190,3895,-295,-7.04,910963,3593187395
180640,한진칼,40650,37450,-3200,-7.87,5545287,212559862650
18064K,한진칼우,29000,30500,1500,5.17,781963,26774802050
005110,한창,850,917,67,7.88,94183965,93747308648
009460,한창제지,1590,1335,-255,-16.04,3479909,5205980130
372910,한컴라이프케어,5440,5850,410,7.54,28135227,181899071490
000880,한화,29050,25650,-3400,-11.7,2881298,79480888500
00088K,한화3우B,15200,13850,-1350,-8.88,700689,10278504550
088350,한화생명,2515,2770,255,10.14,35647664,90690091025
000370,한화손해보험,4235,4660,425,10.04,7511907,32596519680
009830,한화솔루션,51300,43000,-8300,-16.18,24000437,1145527410900
009835,한화솔루션우,37950,33800,-4150,-10.94,107277,3962394700
272210,한화시스템,11500,10550,-950,-8.26,8623255,95649852000
012450,한화에어로스페이스,72600,73600,1000,1.38,12259565,866228658700
000885,한화우,34450,32750,-1700,-4.93,20299,730715600
003530,한화투자증권,2640,2350,-290,-10.98,9346185,24339381905
003535,한화투자증권우,5350,5040,-310,-5.79,89588,477922665
195870,해성디에스,42150,35850,-6300,-14.95,1583615,62312216300
101530,해태제과식품,6380,6590,210,3.29,3266283,23701475280
143210,핸즈코퍼레이션,3585,3305,-280,-7.81,583653,1939797835
000720,현대건설,41000,34900,-6100,-14.88,10437302,386739258400
267270,현대건설기계,59900,62200,2300,3.84,5326251,327544944900
000725,현대건설우,62400,55000,-7400,-11.86,55137,3297609200
005440,현대그린푸드,7050,6730,-320,-4.54,4736793,33209274330
086280,현대글로비스,176500,163500,-13000,-7.37,1298278,221688780500
042670,현대두산인프라코어,8290,8000,-290,-3.5,82091336,665168285720
064350,현대로템,31850,28400,-3450,-10.83,49062815,1417419084250
079430,현대리바트,10250,8590,-1660,-16.2,1957715,19298677750
012330,현대모비스,213000,200500,-12500,-5.87,3579530,740610549700
010620,현대미포조선,86500,84500,-2000,-2.31,5177638,441951680435
069960,현대백화점,60300,59000,-1300,-2.16,1151766,69047587700
004560,현대비앤지스틸,11700,10350,-1350,-11.54,629884,6915367250
004565,현대비앤지스틸우,57100,50000,-7100,-12.43,3186,178448600
004310,현대약품,4845,4790,-55,-1.14,9241606,46234399270
322000,현대에너지솔루션,65900,48800,-17100,-25.95,2594266,147695460450
017800,현대엘리베이,29800,28300,-1500,-5.03,2182026,63822446300
307950,현대오토에버,111000,95500,-15500,-13.96,805956,82635495300
011210,현대위아,59800,49450,-10350,-17.31,2516397,136990561450
267260,현대일렉트릭,42050,42500,450,1.07,6230650,253795314850
004020,현대제철,33900,30600,-3300,-9.73,7019512,228066987650
329180,현대중공업,118500,116000,-2500,-2.11,2822234,334893339500
005380,현대차,169000,151000,-18000,-10.65,11387686,1829697456485
005387,현대차2우B,82200,73900,-8300,-10.1,1654650,131867458900
005389,현대차3우B,79400,72800,-6600,-8.31,121721,9435153700
005385,현대차우,83800,74000,-9800,-11.69,896634,71136949699
001500,현대차증권,10150,9090,-1060,-10.44,1582070,15634014350
011760,현대코퍼레이션,18150,16200,-1950,-10.74,535501,9402727350
227840,현대코퍼레이션홀딩스,10950,10350,-600,-5.48,593032,6734331800
126560,현대퓨처넷,2575,2505,-70,-2.72,3242320,8319889795
001450,현대해상,30200,29450,-750,-2.48,9670588,288483610576
057050,현대홈쇼핑,49650,53900,4250,8.56,434888,23916768000
093240,형지엘리트,1560,1310,-250,-16.03,3469717,5072426685
003010,혜인,7200,6050,-1150,-15.97,11556687,76757351110
111110,호전실업,8250,8110,-140,-1.7,2367634,19921912530
008770,호텔신라,73000,83100,10100,13.84,8591835,686785145400
008775,호텔신라우,53900,62900,9000,16.7,234670,15067124500
002460,화성산업,12850,10500,-2350,-18.29,1834045,22543335050
378850,화승알앤에이,4240,3595,-645,-15.21,1769262,6942233805
241590,화승엔터프라이즈,9370,9230,-140,-1.49,6983015,68027191210
006060,화승인더,4035,3850,-185,-4.58,2416354,9750052865
013520,화승코퍼레이션,1690,1400,-290,-17.16,1666995,2626355190
010690,화신,9130,7220,-1910,-20.92,4550432,38058618560
133820,화인베스틸,2220,2090,-130,-5.86,1164352,2574176530
010660,화천기계,4100,3150,-950,-23.17,27263475,104366340550
000850,화천기공,32800,30650,-2150,-6.55,94125,3031049450
016580,환인제약,17550,17600,50,0.28,603030,10625233900
032560,황금에스티,7780,6970,-810,-10.41,2764421,20692492050
004800,효성,76500,67100,-9400,-12.29,1291851,96115010700
094280,효성ITX,14200,13550,-650,-4.58,100041,1413921750
298040,효성중공업,84700,78000,-6700,-7.91,2231780,181843894700
298050,효성첨단소재,393500,333500,-60000,-15.25,423480,152690501500
298020,효성티앤씨,357000,350000,-7000,-1.96,687706,246481396000
298000,효성화학,125000,99500,-25500,-20.4,472326,53020032500
093370,후성,13250,10700,-2550,-19.25,12424990,151278622500
081660,휠라홀딩스,33050,33250,200,0.61,4090136,137163347876
005870,휴니드,6320,6050,-270,-4.27,3721113,23241489490
079980,휴비스,5160,4885,-275,-5.33,372598,1882734280
005010,휴스틸,5420,5070,-350,-6.46,9608972,49226534830
000540,흥국화재,3165,3370,205,6.48,15972406,59888402133
000547,흥국화재2우B,19300,16200,-3100,-16.06,18918,364549550
000545,흥국화재우,6020,6150,130,2.16,68957,432345040
003280,흥아해운,1625,1355,-270,-16.62,4552374,6915159460
